Company Contact Directory â€” Updated January 2026

Alice Johnson: alice.johnson@techcorp.com
Bob Martinez: bob.martinez@designstudio.io
Carol White
David Kim: d.kim@globalfinance.com
Emily Chen: emily.chen@healthtech.org
Frank O'Brien: frank.obrien@lawfirm.net
Grace Lee: grace.lee@university.edu
Henry Patel
Ibrahim Hassan: ibrahim.h@consulting-group.com
Julia Nakamura: j.nakamura@mediaco.tv
Kevin Wright: kevin.wright@startuphub.co
Laura Santos: laura.santos@nonprofit.org
Michael Brown: m.brown@engineering-inc.com
Nancy Taylor: nancy.t@retailchain.com
Oscar Fernandez
Patricia Williams: p.williams@government.gov
Quincy Adams: quincy.adams@research-lab.org
Rachel Green: rachel.green@fashionhouse.com
Samuel Davis: s.davis@logistics-pro.com
Tanya Ivanova: tanya.i@tech-solutions.eu
Uma Krishnan: uma.k@biotech-innovations.com
Victor Morales: victor.morales@mediagroup.com
Wendy Chang: wendy.chang@edtech-platform.com
Xavier Dubois
Yuki Tanaka: yuki.tanaka@auto-corp.jp
Zachary Thompson: zach.t@cybersecurity-firm.com
Amara Osei: amara.osei@pan-african-trade.com
Benjamin Foster: ben.foster@cloudservices.io
Catherine Dupont: c.dupont@luxury-brands.fr
Derek Washington: d.washington@sportsagency.com
